███████████████████████
█@█                █ ██
█ █ █ ████████████ █ ██
█   █ ████████████ █ ██
█ ███ █        ███ █ ██
█ ███ █ ████ █ ███ █ ██
█ ███ █ ████ █ ███   ██
█ ███ █    █ █ ████████
█ ███ ████ █ █        █
█ ███ ████ █ █ ██████ █
█   █ ████ █ █ ██     █
█████ ████ █ █ ████████
█████      █ █       $█
███████████████████████
